11111111
1C000001
100110P1
101  111
101  1E1
10011001
1C0000C1
11111111
