111111111
100P00M01
110000E01
11CC11111
111111111
