111111111
100PCE001
111111111
100000001
111111111
