11111111111111111111111
1PC01111111110000000001
110E0000CCCCCCCCCCCCC01
11100000CCCCCCCCCCCCCC1
11100011111111111111111
11111111111111111111111
