11111
1C111
11111
100P1
10001
1CCE1
11111
