11111
10001
1PCE1
1M001
11111
